1111111111111111
10000000000000E1
1000C00000000001
10000000000001
100000000P000001
1111111111111111
