1111111111
10000100E1
1000011101
1000000C01
10000000P1
1000000001
1000000001
1000000001
1111111111
1111111111
1111111111
