1111111111111111
10000000000000E1
100E000000000001
1000000000000001
100000000P0000C1
1111111111111111
