1111111111111111
10000000000001E1
1000000000000111
1000C00000000001
100000000P000001
1111111111111111
