1111111111111111111111
1000000000000000000011
1000000000000000000011
1000000000000000000011
1000000000000000000011
1000000000000000000011
1000000000000000000011
1000000000000000000011
1000000000000000000011
10000000000000000CEP11
1111111111111111111111
1111111111111111111111
