1111111111111111
1C010000100C00E1
10010100C0001001
1101010010001001
10C000010P00C001
1111111111111111
